111111111111111111111111111111
120000000060000200000000000001
100000000000000000000000000901
100111111111111111111111001001
100000002000050000000000000001
100000000000000000000000000001
100111111111111111111111001001
100100000000200000000001001201
100100000000000000000001001001
100100111111001111111001001001
120100100000500000001001001001
100190100000000000001001501601
100100100111111111201201001001
100100120100002011001001001001
100100100100000011001001201001
100100100100110011001001001001
100020170100110011000001000501
100000100100113011000001000001
111111111100110011001111111111
120000100000112000001501000201
100000100000110000001001000001
100100100100111111111001001001
100190100120000020000001001001
100100100100000000000001001501
100100100111001111111111001001
100100000000200000002000501001
100100000000000000000000001001
160100100111111111111111111001
100120000000005000060000000201
150100000000000000000000000001
100111111111111111111111111001
100110000200000000020000011901
100110000000000000000000011001
100110011111110011111110011001
100000015000006000005010000001
100000010000000000000010000001
100110011111110011111110011001
120110002000005000020000011501
100110000000000000000000011001
111111111111111111111111111111

background=1
