111111111111111111111111111111
120000000000020000000002000501
100000000000000000000000000001
100111100111100111111111111001
100100060020100150002000001001
100100000000100100000000001001
100100100100100100111111000201
100000030000000120000600000001
100000000000000100000000001001
120100100100000111100111111901
100120000000100120000000201001
100100000000100100000000001001
100111100111100100111110011001
100000000020000100100000000201
100000000000000120050000000001
100190111111100100000110011001
100100150000000110011100000001
100100100000000200000020000001
100100100111000000000000111001
120120100100001111111111111001
100100100100001900000060000201
100100100100111000000000000001
100100120600201001001111111001
150150100000001201201200201001
100100111001001001001000001001
100100100001001000000001000001
100100100001001000000001000001
160120100111001001111111111001
100100120000501200000000501001
100100100000001000000000001001
100100100111111001111100111001
120000000000000000020000000201
100000000000000000000000000001
111111111100100110011111111111
100000090100100500010000060001
100000000100100000010000000001
100111100100100110010010011001
170150000020100600000012000501
100100000000100000000010000001
111111111111111111111111111111

background=2
