111111111111111111111111111111
150000020006000002010002011501
100000000000000000010000011001
100111111111110010010010011001
100020000000000010010010011001
100000000000000010010010060001
100111100111110010002010000001
100100090000002010000011001001
100100000000000010010011001201
160100111110010010010011001001
100150000200000000015000001901
100100000000000000010000001001
100111001111111110011111200001
120000000000002000000001000001
100000000000000000000001111001
111111111110011111111000600001
190060000000050000200000000001
100000000000000000000001111001
100111100111111001111000000201
120150120120000000000000000001
100100100100000000000001501901
100100100100100111100111001001
100000000000120160000200000001
100000000000100100000000000001
111111100111100100111111111001
100030000000000020000000000201
100000000000000000000000000001
100111100100111111111001111111
100100000120000000200001200501
100100000100000000000001000001
120100100100100100111001001001
100160100100150100190700001001
100100100100100100100000001001
100100100000100100100111111001
100020100000120000120006000001
100000100100100000100000000001
100111100100111001111111111001
150090020120000000020000000201
100000000100000000000000000001
111111111111111111111111111111

background=4
smartLevel=0.5
monstersSpeed=1
gems=5
coins=20
timeLimit=550

#AUTO-SPIKES#
@@216,120,100,100,false,0@56,200,100,200,false,0@192,248,20,80,true,0@@
#AUTO-SPIKES#

#PREASURE-PLATE#
@@136,104@48,104@80,200@@
#PREASURE-PLATE#

#WALL-PLATE#
@@136,224;136,232;128,232;128,224;120,224;120,232;112,232;112,224;104,224;104,232;96,232;96,224@136,88;144,88;144,80;136,80;136,72;144,72;144,64;136,64;136,56;144,56;144,48;136,48;136,40;144,40;144,32;136,32;136,24;144,24;144,96;136,96@96,160;96,152;104,152;104,160;112,160;112,152;120,152;120,160;128,160;128,152;136,152;136,160;144,160;144,152;152,152;152,160;160,160;160,152@@
#WALL-PLATE#