111111111111111111111111111111
150000111111100020006000200501
100020000111100000000000000001
100100000200000100111111111001
100111100000000100190020000001
120130111001100100100000000001
100100150002000100000100111001
100100100000000100000100120001
100100111001100100111100100001
100100000200000000020000100111
100100000000000000000000150001
100100111111111100100100100001
100100000600020000100100111001
120100000000000000100120000601
100111111111111100160100000001
160000002009000020100100111111
100000000000000000100100000201
100100111110011100100100000001
190100005002000100020000011001
100100000000000100000000010001
100100111111100100111110019001
150100020000000020006010010011
100100000000000000000010015011
100100100100100100110015010011
100100190100100100005010010201
120000100150020100000010010001
100000100100000100111110011001
100111100111111100000012000001
100000020000000000000010000001
100000000000000000110011111001
100111111111100102010006000001
120000006002090100010000000001
100000000000000110010011111001
111100111111100000000007000001
150100000500000000000000000001
100100000000000110011111111001
100100111111100110011111111001
160000000200000002000050000201
100000000000000000000000000001
111111111111111111111111111111

background=5
smartLevel=0.3
monstersSpeed=2
gems=5
coins=20
timeLimit=550
