111111111111111111111111111111
150000000002000000000200000501
100000000000000000000000000001
100111100111111001111111111001
120000100003000000006000001001
100000100000000000000000001001
100100111111111111111111001201
100060000000020000000200501001
100000000000000000000000001001
100111100111111111190111111001
100000150000020000000002000001
100000100000000000000000000001
100100111111111111111111111001
120120150000200000000002000601
100100100000000000000000000001
190100100111111100100111111001
100000020000000020100002000001
100000000000000000100000000001
100111111111100111100111111001
100000020000060000020000501901
100000000000000000000000001001
100111111111100111111111001201
100020000500000000200601001001
100000000000000000000001201001
100100111111111111111001001001
100100000000902000000000000001
100100000000000000000000000001
120100100111111111111001111001
100100120005000000000000201001
160120100000000000000000001001
100100100111111001001001001001
100100000000201201001001000001
100100000000001001001201000001
100100111111001001201001111001
120150002000600901001500000201
100100000000000001001000000001
100111110011111111001111111001
150000000000200000700000000501
100000000000000000000000000001
111111111111111111111111111111

background=5
smartLevel=0.4
monstersSpeed=2
gems=5
coins=20
timeLimit=600

#AUTO-SPIKES#
@@56,56,100,100,true,0@8,152,100,100,true,0@192,200,100,100,true,0@64,296,100,100,true,0@192,8,100,100,true,0@@
#AUTO-SPIKES#