111111111111111111111111111111
120000011000001000002000090201
100000060000001000000000000001
100110000001001001001100111001
100111100111060001001150111001
100110020001000001001100111001
150000000000001000000020000001
100000011000001000000000000001
100111111111111111111111001001
100002000600050000002000001001
100000000000000000000000001001
100111111111100111111111001001
100001000000000000200000001001
100001000000000000000000001001
111901001111111111111001001201
111001201200000000501001001001
120501001000000000001001001001
100001001001100111001201001001
100111001001000301001001000501
100111001001000001000001000001
100111000001001001000001111111
100500000001060001001001000201
100000001001000001001001000001
111111001001110011001001001001
100000001200000000501001601001
100000001000000000001001001001
100111001111111111111001001901
100001000002000000000201201001
100001000000000000000001001001
111001111111110011111111001501
111200000600005000000000201001
111000000000000000000000001001
111001111111111111111111001001
150000900000001000020000000001
100000000000001000000000000001
100111111111060501111111001001
100111111111000001111111001001
120000200000001000002000001701
100000000000001000000000001001
111111111111111111111111111111

background=1
