111111111111111111111111111111
160000020100060005000001200501
100000000100000000000001000001
100100100000100111111001001001
190050100000100090200001001901
100000100100100000000001001001
100111100100111100111000001001
120000000120000000001000001001
100000000100000000001001001001
100100111111100111001001000201
100000050120000000501001900001
100000000100000000001201001111
100111190100111001111001000001
120000100100100000000601000001
100000120000100000000001001001
111100100000100111111111001201
150100100100000030000000001001
100120160100000000000000001001
100100100100111111100111111001
190100100100000020000000000501
100000100100090000000000000001
100000120000100111111110011111
100100100000100000020000000001
100100111111100000000090000001
160120000000020100111100111001
100100000000000100150100100201
100111111001111100100100100001
120000001501002000100100100111
100000001001000000120100150001
111111001001001100100100100001
100000200000007000060000111001
100000000090000000000000000201
100111111100111100111100000001
120060000000100000111111111111
100000000000100000000200900201
100111190100100100000000000001
100111100100100100111111111001
120050000120000020000600000501
100000000100000000000000000001
111111111111111111111111111111

background=4
smartLevel=0.2
monstersSpeed=1
gems=5
coins=20
