111111111111111111111111111111
120500012000000020120000000201
100000010000000000100000000001
190110010011501100100116011901
100110010011001100100110011001
160110000020116000000501150001
100110000000110000000001100001
120110010011501100100112011001
100112010011001100100110011001
100110012000000020120000000201
100000010000000000100000000001
100000011111901111111110011111
100110012000000020120000000201
100112010000000000100000000001
100110010011601100100115011001
150110010011001100100110011001
100110000050115000000201160001
120110000000110000000001100001
100110010011201100100115011001
100110010011001100100110011001
100000012000000020120000000201
100000010000000000100000000001
100110011111001111111110011111
100116012000000020120000000201
100110010000000000100000000001
150110010011501100100116011001
100110010011001100100110011001
120110000020116000000501150001
100110000000110000000001100001
100110010011501100100112011001
100000010011001100100110011001
100000012000000020120000000201
100110010000000000100000000001
100110011111111111111110011111
100112000000000020000000000301
100110000000000000000000000001
100111111111111111111111111111
120000000000000020000009000701
100000000000000000000000000001
111111111111111111111111111111

background=2
