111111111111111111111111111111
130002000001001200600002001001
100000000001001000000000001001
100111111001111001110011111111
100000000020000000000200000201
100000000000000000000000900001
100100100111001001001001001001
100120105000001201001001001001
100100100000001001001001201001
100100111111201000001001001001
100160020000001000001501001001
100100000000001001201001001001
100100111190111001001001001001
100100170100000501001001501001
100100100100000001600201001001
100100111100111111000001001001
100100111100111111001111001001
100120050000002000000000201001
100100000000000000000000001001
100111111111111111111111111001
100111111111111111111111111001
100100020000000020000001001001
100100000000000000000001001001
100100111111111100100111111001
100100020000100100100020001001
100100000000100190100000001001
100100111100111100100101001001
100150000000060000100101001001
100100000000000000150000001001
100111111100100100100000001001
100100020000100100111111001001
100190000000150120000000201001
100100111111100100000000001001
100100111111100111111111111001
120000002000000000200600000201
100000000000000000000000000001
100111111111100111111111111001
100060050020000000020050000001
100000000000000000000000000001
111111111111111111111111111111

background=5
smartLevel=0.5
monstersSpeed=2
gems=5
coins=20
timeLimit=1100

#AUTO-SPIKES#
@@8,48,150,40,true,130@8,64,150,40,true,120@8,80,150,40,true,110@8,96,150,40,true,100@8,112,150,40,true,90@8,128,150,40,true,80@8,144,150,40,true,70@8,160,150,40,true,60@8,176,150,40,true,50@8,192,150,40,true,40@8,208,150,40,true,30@8,224,150,40,true,20@8,240,150,40,true,10@8,256,150,40,true,0@216,48,150,40,true,0@216,64,150,40,true,10@216,80,150,40,true,20@216,96,150,40,true,30@216,112,150,40,true,40@216,128,150,40,true,50@216,144,150,40,true,60@216,160,150,40,true,70@216,176,150,40,true,80@216,192,150,40,true,90@216,208,150,40,true,100@216,224,150,40,true,110@216,240,150,40,true,120@216,256,150,40,true,130@@
#AUTO-SPIKES#

#MANUAL-SWITCH#
@@168,168,false@96,8,false@192,168,false@216,8,false@104,192,false@@
#MANUAL-SWITCH#

#WALL-SWITCH#
@@88,16;88,8;112,8;112,16@184,168;184,176;192,184;200,184@216,24;224,24;208,16;208,8@96,200;96,192;120,200;120,192@56,128;64,128;64,120;56,120@@
#WALL-SWITCH#