111111111111111111111111111111
130000000201501001006001200601
100000000001001001000001000001
100111111001201000001001001001
100000200000001000001001001001
100000000000001201001001001001
100111001111001001001001001201
120000500000000001201000901001
100000000000000001001000001001
100111111111111001001201001001
100002006000000000001001001501
100000000000000000001001201001
100111110011111111001001001001
190002000000205000000001001001
100000000000000000000001001001
100111111111111111111001001001
120000500002000000200000001001
100000000000000000000000001001
100111111110011111111111001001
100002000006000020050000000201
100000000000000000000000000001
100111111111111111111111111111
100000000020006000200000000111
100000000000000000000000000111
100100100111111111111100120001
100100190150000020150100100001
120120100100000000100100111001
100100120100111100100100100201
100100100120120000090100100001
100000100100100000000150100111
100000100100100100100100100601
100100100000060100100111100001
100100100000000100120000000111
120120100111111100100000000111
100100100200002000100111100201
100100100000000000100170100001
100100100111001100100100111001
160050100200005000020100000001
100000100000000000000100000001
111111111111111111111111111111

background=2
