111111111111111111111111111111
190120000000003000200000201901
100100000000000000000000001001
100100111110011111111111001001
111100120000011112006000001111
100100100000011110000000001001
100100100110011110011111111001
100100160112011110000200001001
100100100110011110000000001001
100100100110011110011111001001
100120000000011112005000201001
100100000000011110000000001001
100111100110011111111111001001
100120000010011112006000001001
100100000010011110000000001001
100100112015011110011111001001
100150000010011110010000201001
100100000010011110010000001001
100111110010011112012010011001
100120000002011110010010011001
100100000000011110015012011001
100100111111111110010010011001
100100060000011110010010011001
100100000000011112000000011001
100190100110011110000000011001
100100100110011110011111111001
100120120112011110010020001001
100100100110011110010000001001
100100100110011110010011901001
100100100110011110010011001001
100100050000011110010011501001
100100000000011112005011001001
100100111110011110000011201001
100100111110011111111111001001
100120000002011112000600001001
100100000000011110000000001001
100111111111111110011111001001
100150206005017010000500201001
100100000000010010000000001001
111111111111111111111111111111

background=5
smartLevel=0.5
monstersSpeed=2
gems=5
coins=20
timeLimit=900

#MANUAL-SWITCH#
@@136,296,false@160,184,false@64,152,false@@
#MANUAL-SWITCH#

#WALL-SWITCH#
@@96,288;88,288;32,288;40,288;120,288;112,288;112,24;120,24@216,32;224,32@16,32;8,32@@
#WALL-SWITCH#

#PREASURE-PLATE#
@@216,40@216,56@216,72@216,88@216,104@216,120@216,136@216,152@216,168@216,184@216,200@216,216@216,232@216,248@216,264@216,280@8,40@8,56@8,72@8,88@8,104@8,120@8,136@8,152@8,168@8,184@8,200@8,216@8,232@8,248@8,264@8,280@@
#PREASURE-PLATE#

#WALL-PLATE#
@@120,40;112,40@120,56;112,56@120,72;112,72@120,88;112,88@120,104;112,104@120,120;112,120@120,136;112,136@120,152;112,152@120,168;112,168@120,184;112,184@120,200;112,200@120,216;112,216@120,232;112,232@120,248;112,248@120,264;112,264@120,280;112,280@112,32;120,32@112,48;120,48@112,64;120,64@112,80;120,80@112,96;120,96@112,112;120,112@112,128;120,128@112,144;120,144@112,160;120,160@112,176;120,176@112,192;120,192@112,208;120,208@112,224;120,224@112,240;120,240@112,256;120,256@112,272;120,272@@
#WALL-PLATE#