111111111111111111111111111111
150100000000110006000011000001
100100000000110000000011000001
100020100100200010010050001001
100000100100000010010000001201
100111100111001110011100111001
100000000000000002000000000001
100000000000000000000000000001
100110011111111110011111001111
120110010009000010011000000001
100110012000002010011000000001
100110010010010010011001111001
100600010015010010201201501201
100000010010010010001001001001
100110010011110011001001001001
120110010002000011001000600001
100110010000000011001000000001
100110011110011111001111111111
100900000000000000000000000201
100000000000000000000000000001
111001111110011110011111111001
111001110000000010010000201901
111001110000000012010000001001
111001112011112010010011001001
111001110015010010012060000001
100500010010010010010000000001
100000010010010010010011001001
100110010002000012010050001001
160110010000000010010000001001
100110011111111110011111111001
100200000000200000000000000201
100000000000000000000000000001
111001111111001111111100111111
100000000000300000000070000901
100000000000000000000000000001
100111115011111116011111111501
100111110011111110011111111001
100020000000020000000200000001
100000000000000000000000000001
111111111111111111111111111111

background=1
