111111111111111111111111111111
150000020000016002000000000501
100000000000010000000000000001
100111111110010010011100111001
100100002000010010019020000001
120100000000010010010000000001
100100111110010010010010011001
100190000005000010000010011001
100100000000000010000010011601
100100100111111110011110011001
160000120000000002000000011001
100000100000000000000000011001
111111100111001111111110011001
120000000000000300000000000201
100000000000000000000000000001
100100100100111111001111100111
100120120100150000600050100001
100100100100100000000000100001
160100100100111001001111111001
100150000120000201200000200001
100100000100000001000000000001
100111100100111001111001111001
120000000000100000000000000201
100000000000100000000000000001
111110011111111111111001111001
120000000000600000000201501001
100000000000000000000001001001
100111111201111001001001601001
160005000000000001001001001001
100000000000000001201001901001
100111111111170111001000000201
100000020000100111001000000001
100900000000111111001111111111
111001111100150000000000000601
100000020000100000000000000001
100000000000100111111120120111
100111111111100111111100100111
150200000000020006000000000501
100000000000000000000000000001
111111111111111111111111111111

background=3
smartLevel=0.45
monstersSpeed=2
gems=5
coins=20
timeLimit=600

#AUTO-SPIKES#
@@40,200,40,200,false,0@200,104,100,50,true,0@@
#AUTO-SPIKES#

#MANUAL-SWITCH#
@@104,176,true@@
#MANUAL-SWITCH#

#MANUAL-SPIKES#
@@192,176,true;144,264,true;32,104,true;136,40,true@@
#MANUAL-SPIKES#

#WALL-SWITCH#
@@120,216;128,216;88,232;88,224@@
#WALL-SWITCH#