111111111111111111111111111111
100002010000000060001701000001
100000012000000000001001000001
150116010011111111111111001111
100000010000003000000000001501
100000010000000000000000001001
111111111111110011110011001001
100000000000010010000001201001
100000000000010010000001001001
120111110010010010011001001901
100000000012010000020000001001
100000000010010000000000001001
111111110000011111111111001001
100200010000010000000010001001
100000011111110000000010001201
100110012065012015010010011001
100110010000010010010012001001
100900011111110000000010001001
100000010000010000000011001001
111111110000011111111111111001
100000010010000200001020000001
100000012010000000001000000001
150116010010011111001111111001
100110010010010000001000000201
100110015010010000001000000001
100110010010010011901001111111
120119011110010011001200000001
100110010002000011001000000001
100110010000000011001001111001
100000011001110011001001001601
100000011000006000001001001001
111110011000000000001000500001
120000201001111111001000000001
100000001000020000001111111111
111111111000000000002000000501
100000001001111111000000000001
100000001001111111111110011111
150116011200050000020000060001
100110011000000000000000000001
111111111111111111111111111111

background=3
smartLevel=0.4
gems=5
coins=20
timeLimit=900

#MANUAL-SWITCH#
@@24,280,false@216,8,false@8,120,false@192,232,false@24,8,false@24,160,false@@
#MANUAL-SWITCH#

#WALL-SWITCH#
@@160,16;160,8;184,8;184,16@104,88;104,80;24,96;32,96@200,152;192,152;176,128;176,120@104,120;104,128;56,128;56,120;160,160;160,168;160,248;160,240;56,224;56,216@64,280;64,288;24,272;32,272@48,48;40,48@@
#WALL-SWITCH#