111111111111111111111111111111
150000200000003000000002000501
100000000000000000000000000001
100111111111001100111111111001
100150002000006000000200501001
100100000000000000000000001001
100100111111100001111111001001
100100150020000000200501001901
190100100000000000000001001001
100100100111110011111001001001
100100100150002000501001001001
120120120100000000001201201201
100100100100111111001001001001
100100100100000201001001001001
100100100100000001001001001001
100100190100111001001901001001
100100100100120001001001001001
100000100100100001001001000001
100000000100100111001000000001
160100020000106001000200001601
100100000000100001000000001001
100000000100111001001000000001
100000100100100201001001000001
100100100100100001001001001001
100100100100100111001001001001
100100100100120000001001001001
120120120100100000001201201201
100100100100111111001001001001
100100100150002000501001001001
100100100100000000001001001001
100100100111119011111001001001
100100150020000000200501001001
100100100000000000000001001001
100100111111100001111111001001
100150002000006000002000501001
100100000000000000000000001001
100111111111001100111111111001
150000200000007000000020000501
100000000000000000000000000001
111111111111111111111111111111

background=5
smartLevel=0.45
monstersSpeed=2
gems=5
coins=20
timeLimit=500
