111111111111111111111111111111
120000000002000000000200000501
100000000000000000000000000001
100111111110013010011111001001
100000500000010010020001001001
100000000000010010000001001001
100111111110010010011001001201
100060110000010010011001001001
100000110000010010011500601001
100100110010010010011000001901
120120112012012010011001111001
100100110010010010020000000001
100100110010010010000000000001
100000000000019011111111100111
100000000000010010000000000001
111111001111110010000000000001
150000200005010010010010011001
100000000000010010012010011201
111111111111110010010010011001
100002000010006000010000050001
100000000010000000010000000001
100111110010010011111111111111
120000000002010012000000000201
100009000000010010000000000001
111110011111110010011100111001
100200000001110010010020001901
100000000001110010010000001001
150110011200010010010011001001
100110011000012015010060001001
111000000110010010010000001001
110000000010010012010011001201
110001100010010010010020001001
112016012010010010010000001001
110010010010010010010011001001
110000000010010010010050001001
110000000010017010010000001001
111110011110010010011111111001
150002000000000002000050000201
100000000000000000000000000001
111111111111111111111111111111

background=1
