111111111111111111111111111111
120000900000500020000006000201
100000000000000000000000000001
100111111111111100111111111001
100110050000000100120000000001
100110000000000100100000000001
100006011100100100100111111001
100000011100100100000150201001
100111111100100100000100001001
120000000020120100100111111001
100000000000100100100000000001
100111001111100120100000000001
100000200000100100100111111111
100000000000190160120005000001
100111111100100100100000000001
100106050100000100100111111001
100100000100000100000003000201
100111111100100100000000000001
120000000020100100100111111001
100000000000100100100111111001
111110011111100100100111111001
100000000200050100120006000001
100000000000000100100000000001
100111111111111100111111111001
100120000020000020000050000201
190100000000000000000000000001
100100111100111100111111111111
100100150100100000002000020001
100100100100100000000000000001
100100100100120110010010011001
100100160100100110010010011001
100020100100100700010010011001
100000100100100000010012011901
100111111100111110010010011001
100000020000002000000010011001
100000000000000000000010011601
100111111100111111110010011001
120005000020000506002010050201
100000000000000000000010000001
111111111111111111111111111111

background=3
smartLevel=0.3
gems=5
coins=20
timeLimit=600

#AUTO-SPIKES#
@@128,192,20,100,true,0@@
#AUTO-SPIKES#

#MANUAL-SWITCH#
@@24,272,false@@
#MANUAL-SWITCH#

#MANUAL-SPIKES#
@@128,24,false;80,272,false;8,96,false@@
#MANUAL-SPIKES#

#WALL-SWITCH#
@@40,160;48,160;144,56;144,64;56,88;48,88;24,120;24,128;64,264;56,264;208,64;208,56@@
#WALL-SWITCH#