111111111111111111111111111111
150020000000002000000002090501
100000000000000000000000000001
100100111001111111001111111001
100100100601000000000000200601
190100100001000000000000000001
100100100111001111111001111001
120100100000300000001200000001
100100100000000000001000000001
100100100111111111001001001111
100120000000020060000001000001
100100000000000000000001000001
100111111001111111001001001001
160005000001200001001000201201
100000000001000901001000001001
100111111001001001001001001001
100111111001001001001001601501
100000020000001501201001001001
100090000000001001001001001901
100100111001001001901200000001
100100101001001001001000000001
100120101201200601001001111111
120100101001000001000000000001
100100111001111111000000000001
100150000009000000001111111201
100100000000000000200000600001
100111110010010011000000000001
100000000012012000001001001001
190000000010010000001501001501
100111110010011111901001001001
100150002010000600001111001111
120100000010000000000200000001
100100111111111111000000000001
100100100017010001111111111001
100000000010010000000200000901
100000000111111000000000000001
100111111111111111111111111001
160002009005000020000000200501
100000000000000000000000000001
111111111111111111111111111111

background=4
smartLevel=0.55
monstersSpeed=1
gems=5
coins=20
timeLimit=600

#MANUAL-SWITCH#
@@120,152,false@216,80,false@112,296,false@8,136,false@96,8,false@192,248,false@@
#MANUAL-SWITCH#

#WALL-SWITCH#
@@96,256@104,272@88,256@104,264@80,264@80,272@@
#WALL-SWITCH#