111111111111111111111111111111
120000050111111100020000111501
100000000100600100000000111001
100111111100000100111100020001
190206010020100000050100000001
100000010000100000000100111001
100111110011111001111100060201
100150000000120001500000000001
100100000000100001000000111001
100111111100000111111100020001
120000200000000002000000000901
100000000000000000000000111001
100111111100100111111120050001
100160000020100000030100000001
100100000000100000000100111001
100111110011111001111100020001
120005010000000000050100000001
100000010000000000000100111001
100111111111001001111100060201
100002000900020000020000000001
100000000000000000000000111001
100111111001111111111100020001
120006000201000002000000000001
100000000001000000000000111001
111111111111001111111111111001
150000000000000000000000601001
100000000000000000000000001001
100111111190111001100111001001
100150020100160000100000201001
100100000000100000100000001001
120100100000100100100100111001
100100060100120050120100501001
100100000100100000100100001001
100100111100110011100100111001
100000020000000000000000001001
100000000000000000000000001001
100111111111111100111111001001
120000005000200000006000201701
100000000000000000000000001001
111111111111111111111111111111

background=2
