111111111111111111111111111111
150106000110050001000000000501
100000000200000001000000000001
190000100000011001001110011001
100111111001111001001000020001
120000001000201000201900000001
100000001000001000001001111001
111111001001001001001000600001
100020001001001001001000000001
100000001020060000000001111001
100111001000000000000001501001
100501001111111111001001001001
100001001000000001001200001001
100111001000000001001000001001
100200001001111001001111111201
100000001001701901200000000001
100111001001001001000000000001
100200001001301001111110011111
100000001001001001200000000201
150111001001111001000000000001
100100001001001001001001100101
111100001001001001001001160001
160000111111001111001001100101
100000000501001000000002000001
111100000001001000000000000001
100000111111001111111001111901
100020000000000000000000001001
100100000000000000000000001001
100000100100110010011111001001
100000100100600010002000501001
100111100100000010000000001201
120000100100110011111111111001
100000120000110000200000000001
100100100000110000000000000001
100100000100110011111100111001
100100000100200010000100020001
100100111100000011111100000001
150000020000110000600000111501
100000000000110000000000111001
111111111111111111111111111111

background=3
smartLevel=0.5
gems=5
coins=20
timeLimit=700

#MANUAL-SWITCH#
@@120,184,false@@
#MANUAL-SWITCH#

#MANUAL-SPIKES#
@@80,96,false@@
#MANUAL-SPIKES#

#PREASURE-PLATE#
@@96,96@72,152@120,152@@
#PREASURE-PLATE#

#WALL-PLATE#
@@64,184;64,192;96,200;104,200;192,224;200,224;184,232;184,240;184,104;184,96;216,24;224,24;208,16;208,8;128,32;120,32;80,56;72,56;24,16;24,24;56,56;48,56;128,256;128,264@104,152;96,152;72,264;72,256;24,256;24,248;24,184;24,176;136,80;136,72;184,136;192,136@24,296;24,304;16,288;8,288;48,192;48,184;16,144;8,144;8,136;16,136;8,128;16,128;16,104;8,104;8,80;16,80;216,272;224,272;192,280;192,288;144,224;136,224;136,184;136,192@@
#WALL-PLATE#