111111111111111111111111111111
120000000020050100060009000501
100000000000000100000000000001
100100100100100120111112011001
100050000160100100111110011001
100000000100100100000000000001
100100100100100100000000000001
100020000000020000111111111001
100000000000000000150020000001
100111100100111100100000000001
100000000000020000100101001001
100000000000000000100000001201
100100100100111100100101001001
150120000130120000100020601001
100100000100100000100000001001
100100100100100100110011111001
100000000000000000000000200001
100000000000000000000000000901
100111111100111100110011111001
120000000060000000200000001001
100000000000000000000000001601
111111001111110011111111201001
100501201117010010000001001201
100001001110010000050000001001
100111000000002000000000000001
120100000000000010020001000001
100100001111111111100111111001
100100111119005010000001501001
100000020110000010000001001001
100000000110011110011000001201
100100100112000000020000001001
120120100110000000000001601001
100100100111111111111111001001
100100100000005000020011111001
160000100090000000000000200001
100000100100111116010000000001
111111100100111110010011111001
150020000100020000000000200501
100000000100000000000000000001
111111111111111111111111111111

background=4
smartLevel=0.45
monstersSpeed=2
gems=5
coins=20
timeLimit=550

#MANUAL-SWITCH#
@@152,216,false@@
#MANUAL-SWITCH#

#WALL-SWITCH#
@@56,120;64,120;64,112;56,112;56,104;64,104;64,96;56,96;56,72;64,72;64,48;56,48;56,40;64,40;64,32;56,32;56,24;64,24;128,192;128,184;184,184;184,192;80,248;72,248;72,240;80,240;128,272;128,264;176,280;176,272;208,128;208,136;160,120;168,120;208,72;208,64;144,112;144,104;120,16;120,8;40,144;32,144;24,152;24,160;48,112;48,104;48,40;48,32;96,16;96,8;8,72;16,72;24,232;24,224;32,288;40,288;104,192;104,200;104,184;104,176@@
#WALL-SWITCH#

#PREASURE-PLATE#
@@80,56@56,264@@
#PREASURE-PLATE#

#WALL-PLATE#
@@64,200;64,192;72,192;72,200;80,200;80,192;88,192;88,200;96,200;96,192;104,192;104,200@96,168;88,168;8,168;16,168;16,288;8,288;128,216;128,224;144,88;144,80;152,32;160,32;160,24;152,24;40,72;32,72;24,104;24,112;72,112;72,104;96,104;96,112;112,96;104,96;104,72;112,72;96,40;96,32;72,32;72,40@@
#WALL-PLATE#