111111111111111111111111111111
160000020000000000200000000501
100000000000000000000000000001
100111111111001111111001001001
100100020001000001111001001001
100100000001000001111001201001
100000111000001000300001001001
100000111000001000000001001001
100100111111001111111111000601
150120005000000000200001000001
100100000000000000000001001901
111100111111111111001001001001
120000000020000000001001001001
100000000000000000001001001001
100111110011100111001001001001
100150010015000201001000200001
100100010010000001001000000001
190112010000011000901001111001
100100010000011000001001000001
150160010012000601001001200501
100100110010000001001001000001
100100010011100111001001001111
100100012000000000000201000001
100112010000000000000001000601
100110010011111111111001000001
100600000000200500000000001001
100000000000000000000000001001
100110011111111111111111111001
120119000200000000020000000501
100110000000000000000000000001
100110011111100111100111111111
100700000200000000000120050001
100000000000000000000100000901
100110011111111111100100111001
120110000200060050100100020001
100110000000000000100000000001
100110011111111111100000111001
150000000200000000020100060201
100000000000000000000100000001
111111111111111111111111111111

background=4
smartLevel=0.4
monstersSpeed=2
gems=5
coins=20

#AUTO-SPIKES#
@@40,200,20,150,false,0@168,120,20,150,true,0@64,96,20,150,true,0@152,224,20,150,true,0@@
#AUTO-SPIKES#