111111111111111111111111111111
100003000000000020000001000501
100000000000000000000001000001
100111111001110011001001001001
100006000200000011001001201001
100000000000000011001001001001
100111111110010011001001001901
120000000000012000501001001001
100000000000010000001600001001
111100111100110011111000001001
150100100000100000001111111001
100100100000100000001002000001
100120100100100111001000000001
100100150120120120501001100111
100100100100100100001000000601
100100100100100100111000000001
120000100100000000000001111111
100000100000000000000000000201
100100100000001111111000000001
100100111001000200000001111501
100120060001000000000020000001
100100000001001111001000000001
100100101001001111001111001111
100100000200001200000000000201
100100101000001000000000000001
120000020901001001111001001901
100000000001200001000001601001
111001111001000001000001001001
111001501001001001001001001001
111001001001001001001001001001
111601901001006001001200000501
111001201001000001001000000001
111001001001111111001111111111
100000001200050000201000700001
100000001000000000001000000001
120111001111111111111001111001
100111001111111111100000200001
150111000200060002000000000001
100111000000000000000111111111
111111111111111111111111111111

background=3
smartLevel=0.4
gems=5
coins=20
timeLimit=700

#MANUAL-SWITCH#
@@184,112,true@56,136,true@120,224,true@56,32,true@@
#MANUAL-SWITCH#

#MANUAL-SPIKES#
@@120,296,true@88,296,true;168,288,true@88,296,true;168,288,true@24,264,false;88,296,true;120,296,true;168,288,true@@
#MANUAL-SPIKES#

#PREASURE-PLATE#
@@168,128@72,160@112,32@48,296@@
#PREASURE-PLATE#

#PLATE-SPIKES#
@@144,152,false;120,264,false@8,168,false;24,264,false;192,64,false@32,56,false;144,152,false;120,264,false;8,168,false@88,296,false;144,152,false;88,136,false;192,64,false@@
#PLATE-SPIKES#