111111111111111111111111111111
150000006020009000000200000001
100000000000000000000000000001
100120111111001001001111001001
100100111111001001001111001001
120000000000201200600500000201
100000000000001000000000000001
111111100100111001001111001001
150000020000001001000201001001
100000000000001001000001001001
100100111111001001001001001901
100000000201201001201000501001
100000000001001001001000001001
120111111001001001001001111001
100120050000001200000200000201
100100000000001000000000000001
100100111111001001111111111001
160000009000201000500200600001
100000000000001000000000000001
111111110011111001111001111001
111000002000001000000000000201
100000000000001000000000000001
120001111111001001901501001001
100111500002001001001001001001
100001000000001001001111001001
100001110010011201200500201001
111001000000001001000000001001
100200000000001001111111111201
100000001201501000000200000001
100111001001001000000000000001
100000111111111001111001001001
100000000000001000001001000001
100100000000001000001001000001
100100111001001201001001001001
120120102001001001500201601001
100100100001001001000001001001
100100100111001001111001001001
100060000000301700000000000201
100000000000001000000000000001
111111111111111111111111111111

background=2
