111111111111111111111111111111
120600020000070000000200000201
100000000000000000000000000001
111111111100111111111111001001
100005000000111111111111001001
100000000000100000020001001001
100111111190100000000001001901
120000000120000111001001001201
100000000100000111501001001001
100111120100100111001001111001
120150000100100600001201000001
100100000100100000001001000001
160100111100100111001601001001
100120000000100000001001001201
100100000000100000001001001001
100111100111111111001001001001
100000000000020000001000001501
100000000000000000001000001001
111111111111111001111111111111
100000020000001001000500000201
100000000000001001000000000001
100100111111001001001111111001
190100111111501001002000001001
100100111111001001000000001501
100100111111001001001001001001
160100020000000000001601001001
100100000000000000001001001001
100100110011111111001001001001
100100110012050201001201001201
100100110010000001001001000001
100100110011100111001001000001
120100002000060000000200001901
100100000000000000000000001001
100111111111111111001111111001
100000000000003000000000001001
100000000000000000000000001001
100111111111001111111111001001
120000050000000002000000000201
100000000000000000000000000001
111111111111111111111111111111

background=1
smartLevel=0.4

#AUTO-SPIKES#
@@120,144,50,200,false,0@@
#AUTO-SPIKES#